2,3,3,7,7,5,5,2,2,2
 2,2,3,3,7,7,5,5,5
11,11,11,11,11,7,5,5,3,3
 2,11,13,7,7,7,2,3,3
2,3,5,5,5,5,5,11,11,11
 2,2,3,3,13,11,5,5,5
2,2,2,7,7,7,11,5,3,3
 3,3,3,3,11,11,11,3,3
3,3,13,3,11,7,5,5,3,3
 2,3,13,3,11,13,13,13,13
2,3,3,3,11,5,13,13,2,2
 2,2,11,11,11,11,5,5,5