2,11,11,11,3,5,5,2,2,2
 7,7,7,7,7,7,5,5,5
5,11,2,7,13,7,5,5,3,3
 11,5,13,7,5,5,5,5,5
11,11,11,5,5,13,5,2,2,5
 5,5,5,5,13,11,5,5,5
2,2,2,7,13,7,11,5,3,3
 3,2,5,13,11,11,11,3,3
3,3,11,13,7,2,2,2,2,2
 2,2,11,13,2,2,2,3,3
2,3,3,11,13,5,2,2,2,2
 2,2,3,11,13,2,5,5,5