2,3,5,5,5,5,5,2,2,2
 2,2,3,3,7,7,5,5,5
5,5,2,7,13,7,5,5,3,3
 2,2,2,7,7,7,2,2,2
2,13,13,13,13,13,13,13,13,2
 2,2,3,3,13,7,7,7,2
2,2,2,7,7,13,7,5,7,2
 5,5,7,7,7,7,7,3,3
3,5,13,7,13,7,5,5,3,3
 3,5,5,7,7,7,13,3,3
2,2,3,2,3,3,3,2,2,2